1111111111111
1V0100C0000C1
1100011111001
1E1011P0000C1
1111111111111